1111111111111
1000000000001
1010010100101
1P00C10C00001
1010010100101
100000C000E01
1111111111111