1111111111111111111
1P000000000C000C001
1010101111110101101
10101000C0000101101
1010001111111101101
1000000C00C00000001
1011111110011110101
1000E00C00C00000101
1111111111111111111