1111111111111111111
100000P0000C000C001
1010101111110101101
101010000E000101101
1010111111111101111
1000000C00C00000001
1011111111111110101
1000000C00000000101
1001111100111110001
100C0000000000C0001
1111111111111111111